spr_tile.txt
8
6
8
-----
0 5 4 5 6 0 0 0 
6 5 5 6 0 6 0 0 
1 1 1 0 0 1 1 1 
1 1 1 0 0 0 6 6 
1 1 1 0 0 6 6 5 
1 1 1 1 1 1 5 4 
6 5 4 4 5 5 5 6 
5 4 4 5 4 4 5 6 
+ comment
-1 -1 -1 -1 -1 -1 -1 -1 
-1 -1 -1 -1 -1 -1 -1 -1 
0 0 1 -1 -1 1 1 1 
1 1 1 -1 -1 -1 -1 -1 
1 1 1 -1 -1 -1 -1 -1 
1 1 1 1 1 1 -1 -1 
-1 -1 -1 -1 -1 -1 -1 -1 
-1 -1 -1 -2 -1 -1 -1 -1 
+ comment
-1 -1 -1 -1 -1 -1 -1 -1 
-1 -1 -1 -1 -1 -1 -1 -1 
-1 -1 1 -1 -1 1 1 1 
0 0 1 -1 -1 -1 -1 -1 
1 1 1 -1 -1 -1 -1 -1 
1 1 1 1 1 1 -1 -1 
-1 -1 -1 -1 -1 -1 -1 -1 
-1 -1 -1 -1 -1 -1 -1 -1 
+ comment
-1 -1 -1 -1 -1 -1 -1 -1 
-1 -1 -1 -1 -1 -1 -1 -1 
-1 -1 1 -1 -1 1 1 1 
-1 -1 1 -1 -1 1 -1 -1 
0 0 1 -1 -1 1 -1 -1 
1 1 1 1 1 1 -1 -1 
-1 -1 -1 -1 -1 -1 -1 -1 
-1 -1 -1 -1 -1 -1 -1 -1 
+ comment
-1 -1 -1 -1 -1 -1 -1 -1 
-1 -1 -1 -1 -1 -1 -1 -1 
-1 -1 0 0 0 0 0 0 
-1 -1 0 0 0 0 -1 -1 
-1 -1 0 0 0 0 -1 -1 
0 0 0 0 0 0 -1 -1 
-1 -1 -1 -1 -1 -1 -1 -1 
-1 -1 -1 -1 -1 -1 -1 -1 
+ comment
-1 -1 -1 -1 -1 -1 -1 -1 
-1 -1 -1 -1 -1 -1 -1 -1 
-1 -1 -1 -1 -1 -1 -1 -1 
-1 -1 -1 -1 -1 -1 -1 -1 
-1 -1 -1 -1 -1 -1 -1 -1 
-1 -1 -1 -1 -1 -1 -1 -1 
-1 -1 -1 -1 -1 -1 -1 -1 
-1 -1 -1 -1 -1 -1 -1 -1 
+comment