room2.txt
0
40
15
basetiletypes.txt
9
10
11
-1 
// Tilemap data
0 0 0 0 0 0 0 0 0 0 0 0 0 0 0 0 0 0 0 0 0 0 0 0 0 0 0 0 0 0 0 0 0 0 0 0 0 0 0 0 
0 0 0 0 0 0 0 0 0 0 0 0 0 0 0 0 0 0 0 0 0 0 0 0 0 0 0 0 0 0 0 0 0 0 0 0 0 0 0 0 
0 0 0 0 0 0 0 0 0 0 0 0 0 0 0 0 0 0 0 0 0 0 0 0 0 0 0 0 0 0 0 0 0 0 0 0 0 0 0 0 
0 0 0 0 0 0 0 0 0 0 0 0 0 0 0 0 0 0 0 0 0 0 0 0 0 0 0 0 0 0 0 0 0 0 0 0 0 0 0 0 
0 0 0 0 0 0 0 0 0 0 0 0 0 0 0 0 0 0 0 0 0 0 0 0 0 0 0 0 0 0 0 0 0 0 0 0 0 0 0 0 
0 0 0 0 0 0 0 0 0 0 0 0 0 0 0 0 0 0 0 0 0 0 0 0 0 0 0 0 0 0 0 0 0 0 0 0 0 0 0 0 
0 0 0 0 0 0 0 0 0 0 0 0 0 0 0 0 0 0 0 0 0 0 0 0 0 0 0 0 0 0 0 0 0 0 0 0 0 0 0 0 
0 0 0 0 0 0 0 0 0 0 0 0 0 0 0 0 0 0 0 0 0 0 0 0 0 0 0 0 0 0 0 0 0 0 0 0 0 0 0 0 
3 4 1 3 6 0 0 0 0 0 0 0 0 0 0 0 0 0 0 0 0 0 0 0 0 0 0 0 0 0 0 0 0 0 0 0 0 0 0 0 
72 72 72 72 24 0 0 0 0 0 0 0 0 0 0 0 0 0 0 0 0 0 0 0 0 0 0 0 0 0 0 0 0 0 0 0 0 0 0 0 
72 72 72 72 24 0 0 0 0 0 0 0 0 0 0 0 0 0 0 0 0 0 0 0 0 0 0 0 0 0 0 0 0 0 0 0 0 21 3 1 
72 72 72 72 24 0 0 0 21 4 3 1 3 1 2 4 2 3 4 3 2 4 1 3 4 3 1 19 20 0 0 0 0 0 0 0 0 25 72 72 
72 72 72 72 26 0 15 16 17 72 72 72 72 72 72 72 72 72 72 72 72 72 72 72 72 72 72 72 18 4 1 2 2 3 4 1 3 7 72 72 
72 72 72 72 8 3 17 72 72 72 72 72 72 72 72 72 72 72 72 72 72 72 72 72 72 72 72 72 72 72 72 72 72 72 72 72 72 72 72 72 
72 72 72 72 72 72 72 72 72 72 72 72 72 72 72 72 72 72 72 72 72 72 72 72 72 72 72 72 72 72 72 72 72 72 72 72 72 72 72 72 
// Tile Entity 0
0
39
9
room1.txt
0
9
2
// Tile Entity 1
0
39
8
room1.txt
0
9
2
// Tile Entity 2
0
39
7
room1.txt
0
9
2
// Tile Entity 3
0
39
6
room1.txt
0
9
2
// Tile Entity 4
0
39
5
room1.txt
0
9
2
// Tile Entity 5
0
0
7
room4.txt
19
7
0
// Tile Entity 6
0
0
6
room4.txt
19
7
0
// Tile Entity 7
0
0
5
room4.txt
19
7
0
// Tile Entity 8
0
0
4
room4.txt
19
7
0
// Tile Entity 9
0
0
3
room4.txt
19
7
0
// Tile Entity 10
2
32
11
3
0
-1
-1
// Tile Entity 11
2
20
10
3
0
-1
-1
// Tile Entity 12
2
10
10
3
0
-1
-1
// End of file
