room1.txt
0
20
15
basetiletypes.txt
9
10
11
-1 
// Tilemap data
0 0 0 0 0 0 0 0 0 0 0 0 0 0 0 0 0 0 0 0 
0 0 0 0 0 0 0 0 0 0 0 0 0 0 0 0 0 0 0 0 
0 0 0 0 0 0 0 0 0 0 0 0 0 0 0 0 0 0 0 0 
0 0 0 0 0 0 0 0 0 0 0 0 0 0 0 0 0 0 0 0 
0 0 0 0 0 0 0 0 0 0 0 0 0 0 0 0 0 0 0 0 
0 0 0 0 0 0 0 0 0 0 0 0 0 0 0 0 0 0 0 0 
0 0 0 0 0 0 0 0 0 0 0 0 0 0 0 0 0 0 0 0 
0 0 0 0 0 0 0 0 0 0 0 0 0 0 0 0 0 0 0 0 
0 0 0 0 0 0 0 0 64 65 66 67 68 69 70 71 0 21 3 4 
0 0 0 0 0 0 0 0 56 57 58 59 60 61 62 63 0 23 72 72 
4 22 0 0 0 0 0 0 48 49 50 51 52 53 54 55 0 23 72 72 
72 26 0 0 0 0 0 0 40 41 42 43 44 45 46 47 0 25 72 72 
72 8 19 20 0 0 30 31 32 33 34 35 36 37 38 39 21 7 72 72 
72 72 72 18 1 2 4 3 1 1 4 2 1 3 4 2 7 72 72 72 
72 72 72 72 72 72 72 72 72 72 72 72 72 72 72 72 72 72 72 72 
// Tile Entity 0
3
7
11
start
0
0
0
// Tile Entity 1
0
0
9
room2.txt
39
9
0
// Tile Entity 2
0
0
8
room2.txt
39
9
0
// Tile Entity 3
0
0
7
room2.txt
39
9
0
// Tile Entity 4
0
0
6
room2.txt
39
9
0
// Tile Entity 5
0
0
5
room2.txt
39
9
0
// Tile Entity 6
0
19
7
room3.txt
0
7
2
// Tile Entity 7
0
19
6
room3.txt
0
7
2
// Tile Entity 8
0
19
5
room3.txt
0
7
2
// Tile Entity 9
0
19
4
room3.txt
0
7
2
// Tile Entity 10
0
19
3
room3.txt
0
7
2
// End of file
