room4.txt
0
20
30
basetiletypes.txt
9
10
11
-1 
// Tilemap data
72 72 72 72 72 72 72 72 72 24 0 0 0 0 0 0 0 0 0 0 
72 72 72 72 150 28 28 28 28 29 0 0 0 0 0 0 0 0 0 0 
72 150 28 28 29 85 85 79 0 0 0 0 0 0 0 0 0 0 0 0 
72 29 85 85 85 85 79 0 0 0 0 0 0 0 0 0 0 0 0 0 
24 85 85 85 85 84 0 0 0 0 0 0 0 0 0 0 0 0 0 0 
24 85 85 85 85 84 0 0 0 0 0 0 0 0 0 0 0 0 0 0 
24 85 85 85 85 82 0 0 0 0 0 0 0 0 0 0 0 0 0 0 
24 85 85 85 84 0 0 0 0 0 0 0 0 0 0 0 0 0 0 0 
8 3 22 85 84 0 0 0 0 0 0 0 0 0 0 0 21 3 4 1 
72 72 24 85 79 0 0 0 0 0 0 0 0 0 0 0 25 72 72 72 
72 72 24 79 0 0 0 0 0 0 0 0 0 0 15 16 17 72 72 72 
72 72 24 0 0 0 0 0 0 0 0 0 0 5 7 72 72 72 72 72 
72 150 77 0 0 0 0 0 0 0 0 21 4 7 72 72 72 72 72 72 
72 24 0 0 0 0 0 0 0 0 86 25 72 72 72 72 72 72 72 72 
72 24 0 0 0 0 0 0 0 86 73 7 72 72 72 72 72 72 72 72 
150 29 0 0 0 0 0 0 86 85 85 23 72 72 72 72 72 72 72 72 
24 0 0 0 0 0 0 21 22 85 85 23 72 72 72 72 72 72 72 72 
24 0 0 0 0 73 74 28 29 85 85 27 72 72 72 72 72 72 72 72 
26 0 0 0 0 0 0 83 85 85 85 85 27 28 72 72 72 72 72 72 
8 2 6 0 0 0 0 83 85 85 85 85 85 85 27 72 72 72 72 72 
72 72 24 0 0 0 0 83 85 85 85 85 85 85 85 27 28 28 28 28 
72 72 24 0 0 0 0 83 85 85 85 85 85 85 85 85 85 85 85 85 
28 28 77 0 0 0 21 1 22 81 81 81 85 85 85 85 85 85 85 85 
85 84 0 0 0 0 25 72 24 0 0 0 83 85 85 85 85 85 85 85 
85 84 0 0 0 21 7 72 26 0 0 0 83 85 85 85 85 85 85 85 
85 79 0 0 0 23 72 72 14 11 0 0 83 85 85 85 85 85 85 85 
84 0 0 0 0 25 72 72 72 12 0 0 83 85 85 85 85 85 85 85 
3 1 4 3 1 7 72 72 72 8 1 4 4 1 2 3 1 4 2 4 
72 72 72 72 72 72 72 72 72 72 72 72 72 72 72 72 72 72 72 72 
72 72 72 72 72 72 72 72 72 72 72 72 72 72 72 72 72 72 72 72 
// Tile Entity 0
0
19
7
room2.txt
0
7
2
// Tile Entity 1
0
19
6
room2.txt
0
7
2
// Tile Entity 2
0
19
5
room2.txt
0
7
2
// Tile Entity 3
0
19
4
room2.txt
0
7
2
// Tile Entity 4
0
19
3
room2.txt
0
7
2
// Tile Entity 5
2
15
26
3
0
-1
-1
// Tile Entity 6
2
11
11
3
0
-1
-1
// Tile Entity 7
0
19
26
room5.txt
0
11
2
// Tile Entity 8
0
19
25
room5.txt
0
11
2
// Tile Entity 9
0
19
24
room5.txt
0
11
2
// Tile Entity 10
0
19
23
room5.txt
0
11
2
// Tile Entity 11
0
19
22
room5.txt
0
11
2
// Tile Entity 12
0
0
26
room6.txt
59
11
0
// Tile Entity 13
0
0
25
room6.txt
59
11
0
// Tile Entity 14
0
0
24
room6.txt
59
11
0
// Tile Entity 15
0
0
23
room6.txt
59
11
0
// Tile Entity 16
2
2
7
3
0
-1
-1
// End of file
