room10c.txt
0
40
15
basetiletypes.txt
68
82
69 
106 
// Tilemap data
122 122 122 122 122 122 122 122 122 122 122 122 122 122 122 122 88 88 88 88 88 88 88 88 88 88 88 88 88 88 88 88 88 88 88 88 88 88 88 88 
88 88 88 88 88 88 88 88 88 88 88 88 88 88 88 88 88 155 155 155 155 155 155 155 155 155 155 155 155 155 155 155 155 155 155 155 155 155 155 155 
155 155 155 155 155 155 155 155 155 155 155 155 155 155 155 155 155 155 88 88 88 88 88 88 88 88 88 88 88 88 88 88 88 88 88 88 89 89 88 88 
88 88 88 88 89 89 88 88 88 88 88 88 88 88 88 88 88 88 88 122 114 112 0 0 0 0 0 0 0 0 0 0 0 0 0 0 0 0 98 117 
121 114 95 113 0 0 94 95 95 95 95 96 94 95 95 113 115 114 96 94 112 0 0 0 0 0 0 0 0 0 0 0 0 124 125 126 0 0 109 95 
121 101 0 97 0 0 0 0 0 0 0 0 0 0 0 98 115 101 0 0 0 0 0 0 0 0 0 0 0 0 0 0 0 127 128 129 0 0 140 0 
121 101 0 0 0 0 0 0 0 0 0 0 0 0 0 109 95 110 0 0 0 0 0 0 0 0 0 0 0 0 0 0 0 130 131 132 0 0 140 0 
116 101 0 0 0 0 0 0 0 0 0 0 0 0 0 0 0 0 0 0 0 0 91 92 93 0 0 0 0 107 92 92 92 92 92 92 92 92 92 92 
95 110 0 0 0 0 0 0 0 0 0 0 0 0 0 0 0 0 0 0 0 0 0 89 0 0 0 0 0 98 119 120 120 120 162 120 120 120 162 120 
100 0 0 0 0 0 0 91 92 92 93 0 0 0 0 0 0 0 0 0 0 0 0 89 0 0 0 0 0 98 123 115 115 115 170 160 160 160 172 115 
102 0 0 0 0 0 0 89 0 0 89 0 0 0 91 92 92 92 93 0 0 0 0 89 0 0 0 107 92 105 123 115 115 115 115 115 115 115 115 115 
91 92 92 104 0 0 0 89 154 0 89 0 0 0 89 0 154 0 89 0 0 0 0 89 154 0 0 98 119 120 115 115 115 115 115 115 115 115 115 115 
120 120 118 106 104 0 0 89 153 0 89 0 0 0 89 0 153 0 89 0 0 0 0 89 153 0 0 98 123 115 115 115 115 115 115 115 115 115 115 115 
115 115 115 118 106 93 91 92 92 93 91 92 92 93 91 92 92 93 91 92 92 93 91 92 92 93 91 105 123 115 115 115 115 115 115 115 115 115 115 115 
115 115 115 115 120 120 120 120 120 120 120 120 120 120 120 120 120 120 120 120 120 120 120 120 120 120 120 120 115 115 115 115 115 115 115 115 115 115 115 115 
// Tile Entity 0
0
0
2
room9.txt
19
2
0
// Tile Entity 1
5
7
10

152
4
-1
// Tile Entity 2
5
7
11

152
4
-1
// Tile Entity 3
5
7
12

152
4
-1
// Tile Entity 4
5
16
7

152
4
-1
// Tile Entity 5
5
16
8

152
4
-1
// Tile Entity 6
5
16
9

152
4
-1
// Tile Entity 7
5
7
2

152
4
-1
// Tile Entity 8
5
25
7

151
4
-1
// Tile Entity 9
5
26
7

151
4
-1
// Tile Entity 10
5
27
7

151
4
-1
// Tile Entity 11
5
28
7

151
4
-1
// Tile Entity 12
5
35
1

152
4
-1
// Tile Entity 13
2
38
6
2
1
0
-1
// Tile Entity 14
5
16
5

156
4
-1
// Tile Entity 15
2
16
5
4
0
4
-1
// Tile Entity 16
0
39
1
room11c.txt
0
1
2
// Tile Entity 17
5
39
1

-1
2
1
// Tile Entity 18
6
14
11
0
157
4
-1
// Tile Entity 19
6
14
12
0
157
4
-1
// Tile Entity 20
6
22
8
0
157
4
-1
// Tile Entity 21
6
22
9
0
157
4
-1
// Tile Entity 22
6
22
10
0
157
4
-1
// Tile Entity 23
6
22
11
0
157
4
-1
// Tile Entity 24
6
22
12
0
157
4
-1
// Tile Entity 25
5
31
9

156
4
-1
// Tile Entity 26
2
31
9
4
0
4
-1
// Tile Entity 27
4
8
12
Blah
-1
-1
-1
// Tile Entity 28
4
16
12
Blah
-1
-1
-1
// Tile Entity 29
4
24
12
Blah
-1
-1
-1
// Tile Entity 30
4
34
6
Blah
-1
-1
-1
// End of file
