room14.txt
0
20
15
basetiletypes.txt
68
69
-1 
106 
// Tilemap data
88 88 88 88 88 98 115 115 115 115 115 115 115 115 115 115 115 115 115 115 
155 155 155 155 155 98 115 115 115 115 115 115 115 115 115 115 115 115 115 115 
88 88 88 88 88 97 115 115 115 115 115 115 115 115 115 115 115 115 115 115 
115 114 95 95 95 113 115 115 115 115 115 115 115 115 114 95 95 95 113 115 
115 101 0 0 0 98 115 115 115 115 115 115 115 115 101 0 0 0 98 115 
115 101 0 0 0 109 95 95 95 95 95 95 95 95 110 0 0 0 98 115 
115 101 0 0 0 0 0 0 0 0 0 0 0 0 0 0 0 0 98 115 
115 101 0 0 0 0 0 0 0 0 0 0 0 0 0 0 0 0 109 95 
115 101 0 0 0 0 0 0 0 0 0 0 0 0 0 0 0 0 0 0 
115 101 0 0 0 0 0 0 0 0 0 0 0 0 0 0 0 0 0 0 
115 101 0 0 0 0 0 0 0 0 0 0 0 0 0 0 0 0 0 0 
115 106 92 92 104 0 0 0 0 0 0 0 0 0 0 103 92 92 92 92 
115 115 115 115 106 104 0 0 0 0 0 0 0 0 103 105 115 115 115 115 
115 115 115 115 115 106 92 92 92 92 92 92 92 92 105 115 115 115 115 115 
115 115 115 115 115 115 115 115 115 115 115 115 115 115 115 115 115 115 115 115 
// Tile Entity 0
0
0
1
room12c.txt
19
1
0
// Tile Entity 1
5
0
1

-1
3
1
// End of file
