room10b.txt
0
40
15
basetiletypes.txt
68
82
69 
106 
// Tilemap data
122 122 122 122 122 122 122 122 122 122 122 122 122 122 122 122 88 88 88 88 88 88 88 88 88 88 88 88 88 88 88 88 88 88 88 88 88 88 88 88 
88 88 88 88 88 88 88 88 88 88 88 88 88 88 88 88 88 155 155 155 155 155 155 155 155 155 155 155 155 155 155 155 155 155 155 155 155 155 155 155 
155 155 155 155 155 155 155 155 155 155 155 155 155 155 155 155 155 155 88 88 88 88 88 88 88 88 88 88 88 88 88 88 88 88 88 88 89 89 88 88 
88 88 88 88 88 89 89 88 88 88 88 88 88 88 88 88 88 88 88 122 114 112 0 0 0 0 0 0 0 0 0 0 0 0 0 0 0 0 98 117 
121 114 95 95 113 0 0 94 95 95 95 96 94 95 95 113 115 114 96 94 112 0 0 0 0 0 0 0 0 0 0 0 0 124 125 126 0 0 109 95 
121 101 0 0 97 0 0 0 0 0 0 0 0 0 0 98 115 101 0 0 0 0 0 0 0 0 0 0 0 0 0 0 0 127 128 129 0 0 0 0 
121 101 0 0 0 0 0 0 0 0 0 0 0 0 0 109 95 110 0 0 0 0 0 0 0 0 0 0 0 0 0 0 0 130 131 132 0 0 0 0 
116 101 0 0 0 0 0 0 0 0 0 0 0 0 0 0 0 0 0 0 0 0 91 92 93 0 0 0 0 107 92 92 92 92 92 92 92 92 92 92 
95 110 0 0 0 0 0 0 0 0 0 0 0 0 0 0 0 0 0 0 0 0 0 89 0 0 0 0 0 98 119 120 120 120 162 120 120 120 162 120 
0 0 0 0 0 0 0 91 92 92 93 0 0 0 0 0 0 0 0 0 0 0 0 89 0 0 0 0 0 98 123 115 115 115 170 160 160 160 172 115 
0 0 0 0 0 0 0 89 0 0 89 0 0 0 91 92 92 92 93 0 0 0 0 89 0 0 0 107 92 105 123 115 115 115 115 115 115 115 115 115 
91 92 92 104 0 0 0 89 154 0 89 0 0 0 89 0 154 0 89 0 0 0 0 89 154 0 0 98 119 120 115 115 115 115 115 115 115 115 115 115 
120 120 118 106 104 0 0 89 153 0 89 0 0 0 89 0 153 0 89 0 0 0 0 89 153 0 0 98 123 115 115 115 115 115 115 115 115 115 115 115 
115 115 115 118 106 93 91 92 92 93 91 92 92 93 91 92 92 93 91 92 92 93 91 92 92 93 91 105 123 115 115 115 115 115 115 115 115 115 115 115 
115 115 115 115 120 120 120 120 120 120 120 120 120 120 120 120 120 120 120 120 120 120 120 120 120 120 120 120 115 115 115 115 115 115 115 115 115 115 115 115 
// Tile Entity 0
0
0
9
room9.txt
19
10
0
// Tile Entity 1
0
0
10
room9.txt
19
10
0
// Tile Entity 2
5
0
10

-1
3
-1
// Tile Entity 3
2
15
12
0
0
-1
-1
// Tile Entity 4
2
32
6
0
0
-1
-1
// Tile Entity 5
2
24
6
0
0
-1
-1
// Tile Entity 6
2
27
9
13
0
-1
-1
// Tile Entity 7
2
27
9
13
0
-1
-1
// Tile Entity 8
2
24
12
13
0
-1
-1
// Tile Entity 9
0
39
5
room11b.txt
0
6
2
// Tile Entity 10
0
39
6
room11b.txt
0
6
2
// Tile Entity 11
6
38
5
0
157
9
1
// Tile Entity 12
6
38
6
0
157
9
1
// Tile Entity 13
9
0
0
-1
0
9
-1
// Tile Entity 14
5
39
6

-1
4
1
// End of file
