room6.txt
0
60
15
basetiletypes.txt
9
10
11
-1 
// Tilemap data
0 0 0 0 0 0 0 0 0 0 0 0 0 0 0 0 0 0 0 0 78 81 85 85 27 149 72 72 72 72 72 72 72 72 72 72 88 72 72 72 72 72 72 72 24 0 0 23 72 72 72 72 72 72 72 72 72 72 72 72 
0 0 0 0 0 0 0 0 0 0 0 0 0 0 0 0 0 0 0 0 0 0 83 85 85 23 72 72 72 72 72 72 72 72 72 72 88 72 72 72 72 72 72 72 24 0 0 27 149 72 72 72 72 72 72 72 72 72 72 72 
0 0 0 0 0 0 0 0 0 0 0 0 0 0 0 0 0 0 0 0 0 0 80 81 79 27 149 72 72 72 72 72 72 72 72 72 88 72 72 72 72 72 72 150 77 0 0 0 27 28 149 72 72 72 72 72 72 72 72 72 
0 0 0 0 0 0 0 0 0 0 0 0 0 0 0 0 0 0 0 0 0 0 89 0 0 0 76 28 28 149 72 72 72 72 72 72 72 150 28 28 28 28 28 77 0 0 0 0 83 85 23 72 72 72 72 72 72 72 72 72 
0 0 0 0 0 0 0 0 0 0 0 0 0 0 0 0 0 0 0 0 0 0 89 0 0 0 0 0 83 27 28 28 28 28 28 28 28 29 85 85 85 85 84 0 0 0 0 0 78 85 23 72 72 72 72 72 72 72 72 72 
0 0 0 0 0 0 0 0 0 0 86 87 0 0 0 0 0 0 0 0 0 0 89 0 0 0 0 0 83 85 85 85 85 85 84 0 89 83 85 85 85 85 84 0 0 0 0 0 0 78 27 28 149 150 28 28 28 149 72 72 
0 0 0 0 0 0 0 0 0 86 85 85 87 0 0 0 0 0 0 0 0 0 89 0 0 0 0 0 83 85 85 85 85 85 84 0 89 78 85 85 85 85 82 0 0 0 0 0 0 0 78 85 27 29 85 85 85 23 72 72 
0 0 0 0 0 0 0 0 0 83 85 85 21 1 4 1 3 19 20 0 0 0 89 0 0 0 0 0 78 85 85 85 85 85 79 0 89 0 83 85 85 79 0 0 0 0 0 0 0 0 0 78 81 81 85 85 85 27 28 28 
0 0 0 0 0 0 0 0 0 83 85 85 23 72 72 72 72 72 18 6 0 0 89 0 0 0 0 0 0 78 85 85 85 84 0 0 89 0 83 85 79 0 0 0 0 0 0 0 0 0 0 0 0 0 83 85 85 85 85 85 
2 1 4 6 0 0 0 0 0 83 85 85 25 72 72 72 72 72 72 8 1 3 4 22 0 0 0 0 0 0 83 85 85 84 0 0 89 0 83 84 0 0 0 0 0 0 0 0 0 89 0 0 0 0 78 85 85 85 85 85 
72 72 72 8 19 20 0 0 0 83 85 21 7 72 72 72 72 72 72 72 72 72 72 24 87 0 0 21 19 20 83 85 85 84 0 73 74 74 75 84 0 0 0 0 0 0 0 0 0 89 0 0 0 0 0 83 85 85 85 85 
72 72 72 72 72 18 4 3 1 2 3 7 72 72 72 72 72 72 72 72 72 72 72 24 85 87 0 76 149 18 3 22 85 84 0 0 0 0 83 84 0 0 21 6 0 0 0 0 0 89 0 0 0 0 0 83 85 85 85 85 
72 72 72 72 72 72 72 72 72 72 72 72 72 72 72 72 72 72 72 72 72 72 72 24 85 84 0 0 76 28 28 29 83 84 0 0 0 0 83 84 0 0 23 8 3 4 1 4 6 89 0 0 15 16 1 2 3 4 3 1 
72 72 72 72 72 72 72 72 72 72 72 72 72 72 72 72 72 72 72 72 72 72 72 26 85 84 0 0 0 0 0 89 83 84 0 0 0 0 83 85 87 0 23 72 72 72 72 72 8 90 92 93 17 72 72 72 72 72 72 72 
72 72 72 72 72 72 72 72 72 72 72 72 72 72 72 72 72 72 72 72 72 72 72 8 4 2 1 3 2 2 3 4 3 1 4 1 3 1 4 2 1 4 7 72 72 72 72 72 72 120 120 120 72 72 72 72 72 72 72 72 
// Tile Entity 0
0
59
11
room4.txt
0
26
2
// Tile Entity 1
0
59
10
room4.txt
0
26
2
// Tile Entity 2
0
59
9
room4.txt
0
26
2
// Tile Entity 3
0
59
8
room4.txt
0
26
2
// Tile Entity 4
2
14
6
1
0
-1
-1
// Tile Entity 5
2
30
10
1
0
-1
-1
// Tile Entity 6
2
45
11
1
0
-1
-1
// Tile Entity 7
0
0
8
room7.txt
19
8
0
// Tile Entity 8
0
0
7
room7.txt
19
8
0
// Tile Entity 9
0
0
6
room7.txt
19
8
0
// Tile Entity 10
0
0
5
room7.txt
19
8
0
// Tile Entity 11
0
0
4
room7.txt
19
8
0
// Tile Entity 12
2
35
9
3
0
-1
-1
// Tile Entity 13
2
27
9
3
0
-1
-1
// End of file
