room13.txt
0
20
15
basetiletypes.txt
68
69
126 
106 
// Tilemap data
115 115 115 115 115 115 101 0 0 0 0 0 0 98 115 115 115 115 115 115 
115 115 115 115 115 115 101 0 0 0 0 0 0 98 115 115 115 115 115 115 
115 114 95 95 95 95 110 0 0 0 0 0 0 109 95 95 95 95 113 115 
115 101 0 0 0 0 0 0 0 0 0 0 0 0 0 0 0 0 98 115 
115 101 0 0 0 0 0 0 0 0 0 0 0 0 0 0 0 0 98 115 
115 101 0 0 0 0 0 0 0 0 0 0 0 0 0 0 0 0 98 115 
115 101 0 0 0 0 0 0 0 0 0 0 0 0 0 0 0 0 98 115 
95 110 0 0 0 0 0 0 0 0 0 0 0 0 0 0 0 0 109 95 
0 0 0 0 0 0 0 0 0 0 0 0 0 0 0 0 0 0 0 0 
0 0 0 0 0 0 0 0 0 0 0 0 0 0 0 0 0 0 0 0 
0 0 0 0 0 0 0 0 0 0 0 0 0 0 0 0 0 0 0 0 
92 92 92 92 92 104 0 0 0 0 0 0 0 0 103 92 92 92 92 92 
115 115 115 115 115 106 92 92 92 92 92 92 92 92 105 115 115 115 115 115 
115 115 115 115 115 115 115 115 115 115 115 115 115 115 115 115 115 115 115 115 
115 115 115 115 115 115 115 115 115 115 115 115 115 115 115 115 115 115 115 115 
// End of file
