room7.txt
0
20
30
basetiletypes.txt
9
10
11
-1 
// Tilemap data
72 72 72 72 72 72 72 72 72 72 150 29 84 0 0 0 0 0 0 0 
72 72 72 72 72 72 72 72 72 72 24 85 84 0 0 0 0 0 0 0 
72 72 72 72 150 28 28 28 28 28 29 85 84 0 0 0 0 0 0 0 
72 72 72 72 24 85 85 85 85 85 85 85 79 0 0 0 0 0 0 0 
72 72 72 72 24 85 85 85 85 85 85 79 0 0 0 0 0 0 0 0 
72 72 72 72 24 78 85 85 85 85 79 0 0 0 0 0 0 0 0 0 
72 72 72 72 24 0 78 85 85 84 0 0 0 0 0 0 0 0 0 0 
72 72 72 150 77 0 0 83 85 79 0 0 0 0 0 0 0 0 0 0 
72 72 72 77 0 0 0 80 79 0 0 0 0 0 0 0 0 0 0 0 
72 72 24 87 0 0 0 89 0 0 0 0 0 0 0 15 16 3 1 4 
72 72 24 85 87 0 0 89 0 0 0 0 0 15 16 17 72 72 72 72 
72 72 24 85 84 0 0 89 0 0 73 74 4 17 72 72 72 72 72 72 
72 72 26 85 84 0 0 89 0 86 85 84 23 72 72 72 72 72 72 72 
72 72 8 1 2 3 22 89 0 83 85 84 76 149 72 72 72 72 72 72 
72 72 72 72 72 72 26 89 0 83 85 84 0 76 28 28 72 72 72 72 
72 72 72 72 72 72 8 4 74 74 75 85 87 0 83 85 23 72 72 72 
72 72 72 72 150 28 28 77 0 83 85 85 84 0 80 85 23 72 72 72 
72 72 72 72 24 85 84 0 0 83 85 85 84 0 0 83 23 72 72 72 
72 72 72 72 24 85 79 0 0 73 74 4 1 19 20 83 25 72 72 72 
72 72 72 72 26 79 0 0 0 0 0 76 149 72 18 3 7 72 72 72 
28 28 28 149 18 19 20 0 0 0 0 86 23 72 72 72 72 72 28 28 
85 85 85 27 149 72 18 19 20 0 86 85 23 72 72 72 72 29 134 135 
85 85 85 85 27 28 149 72 18 75 85 85 23 72 72 72 24 122 122 122 
85 85 85 85 85 85 27 28 29 85 85 85 27 28 28 28 29 94 96 120 
1 4 22 78 85 85 85 85 85 85 85 85 85 85 85 85 85 85 85 85 
72 72 26 0 78 85 85 85 85 85 85 85 85 85 85 85 85 85 85 85 
72 72 14 11 0 83 85 85 85 85 85 85 85 85 85 85 85 85 85 85 
72 72 72 12 86 85 85 85 85 85 85 85 85 85 21 2 3 90 93 122 
72 72 72 8 4 3 1 2 2 1 3 4 2 3 7 72 72 24 120 120 
72 72 72 72 72 72 72 72 72 72 72 72 72 72 72 72 72 24 134 135 
// Tile Entity 0
0
19
8
room6.txt
0
8
2
// Tile Entity 1
0
19
7
room6.txt
0
8
2
// Tile Entity 2
0
19
6
room6.txt
0
8
2
// Tile Entity 3
0
19
5
room6.txt
0
8
2
// Tile Entity 4
0
19
4
room6.txt
0
8
2
// Tile Entity 5
0
0
23
room8.txt
19
8
0
// Tile Entity 6
0
0
22
room8.txt
19
8
0
// Tile Entity 7
0
0
21
room8.txt
19
8
0
// Tile Entity 8
0
19
26
room9.txt
0
11
2
// Tile Entity 9
0
19
25
room9.txt
0
11
2
// Tile Entity 10
0
19
24
room9.txt
0
11
2
// Tile Entity 11
2
5
12
3
0
-1
-1
// Tile Entity 12
2
9
17
3
0
-1
-1
// Tile Entity 13
2
11
17
3
0
-1
-1
// Tile Entity 14
2
11
10
3
0
-1
-1
// Tile Entity 15
2
11
27
3
0
-1
-1
// End of file
