room8.txt
0
20
15
basetiletypes.txt
9
10
11
-1 
// Tilemap data
72 24 0 0 0 0 0 0 0 0 0 0 0 76 149 72 72 72 72 72 
72 24 0 0 0 0 0 0 0 0 0 0 0 0 23 72 72 72 72 72 
150 77 0 0 0 0 0 0 0 0 0 0 0 0 27 28 28 149 72 72 
24 0 0 0 0 0 0 0 0 0 0 0 0 86 85 85 85 27 149 72 
24 87 0 0 0 0 0 0 0 0 0 0 86 85 85 85 85 85 27 149 
24 85 87 0 0 0 0 0 0 0 0 0 83 85 85 85 85 85 85 27 
24 85 84 0 0 0 0 0 0 0 0 0 83 85 85 85 85 85 85 85 
26 85 84 0 0 0 0 0 0 0 0 0 83 85 85 85 85 85 85 85 
8 4 1 22 0 0 0 0 88 0 0 86 85 73 75 85 85 85 85 85 
72 72 150 77 0 0 0 0 89 0 0 83 85 85 85 85 85 85 21 3 
72 72 24 0 0 0 0 0 89 0 0 83 85 85 85 85 85 21 7 72 
72 72 24 87 0 0 0 0 89 0 0 83 85 85 85 85 85 23 72 72 
72 72 24 85 87 0 0 0 89 0 0 83 85 85 85 85 79 25 72 72 
72 72 26 85 84 0 0 0 89 0 0 83 85 85 85 79 5 7 72 72 
72 72 8 3 1 4 2 3 1 2 4 3 1 1 3 4 7 72 72 72 
// Tile Entity 0
0
19
8
room7.txt
0
23
2
// Tile Entity 1
0
19
7
room7.txt
0
23
2
// Tile Entity 2
0
19
6
room7.txt
0
23
2
// Tile Entity 3
2
8
7
3
0
-1
-1
// Tile Entity 4
2
13
7
3
0
-1
-1
// Tile Entity 5
2
8
13
1
0
-1
-1
// End of file
