room5.txt
0
40
15
basetiletypes.txt
9
10
11
-1 
// Tilemap data
72 72 72 72 72 72 72 72 72 72 72 72 72 72 72 72 72 72 72 72 72 72 72 72 72 72 72 72 72 72 72 72 72 72 72 72 72 72 72 72 
72 72 72 72 72 72 72 72 72 72 28 149 72 72 150 28 28 28 28 28 28 28 28 149 150 28 28 72 72 150 28 72 72 72 72 72 72 72 72 72 
72 72 72 72 72 72 150 28 28 77 0 76 28 28 77 0 83 85 85 85 85 85 85 23 24 85 85 27 28 77 83 27 28 28 149 72 72 72 72 72 
72 72 72 72 72 72 24 85 84 0 0 0 0 0 0 0 78 85 85 85 85 85 85 27 29 85 85 79 0 0 83 84 0 0 76 28 28 28 149 72 
72 72 72 150 28 28 29 85 84 0 0 0 0 0 0 0 0 83 85 85 85 85 85 85 85 85 84 0 0 0 80 79 0 0 0 83 85 85 23 72 
28 28 28 29 85 85 85 85 84 0 0 0 0 0 0 0 0 83 85 85 85 79 78 85 85 85 84 0 0 0 0 0 0 0 0 83 85 85 27 149 
85 85 85 85 85 85 85 85 79 0 86 87 0 0 0 0 0 83 85 85 85 87 86 85 85 85 84 0 0 0 0 0 0 0 86 85 85 84 0 23 
85 85 85 85 85 85 85 79 0 0 83 85 87 0 0 0 86 85 85 85 85 85 85 85 85 85 84 0 0 0 0 0 0 86 85 85 85 82 0 23 
85 85 85 85 85 85 84 0 0 0 83 85 84 0 0 86 85 85 85 85 85 85 85 85 85 21 22 0 0 0 0 0 0 83 85 85 84 0 0 23 
85 85 85 85 85 85 84 0 0 86 85 85 84 0 0 83 85 79 78 73 74 75 85 85 85 23 8 22 0 0 0 0 73 75 85 85 84 0 0 25 
85 85 85 85 85 85 84 0 0 83 21 1 4 6 0 83 85 87 86 85 85 85 85 85 79 23 72 24 0 0 0 0 0 83 85 85 85 21 2 7 
85 85 85 85 85 85 84 0 0 83 25 72 72 8 6 83 85 85 85 85 85 85 85 79 0 25 72 26 0 0 0 0 86 85 85 85 85 23 72 72 
1 3 2 2 3 1 2 4 1 4 7 72 72 72 8 4 3 22 85 85 85 85 79 0 10 13 72 8 6 0 0 86 85 85 85 85 85 23 72 72 
72 72 72 72 72 72 72 72 72 72 72 72 72 72 72 72 72 26 85 85 85 84 0 0 9 72 72 72 8 19 20 83 85 85 85 85 85 25 72 72 
72 72 72 72 72 72 72 72 72 72 72 72 72 72 72 72 72 8 3 1 4 3 2 4 13 72 72 72 72 72 18 1 3 2 3 4 1 7 72 72 
// Tile Entity 0
0
0
11
room4.txt
19
26
0
// Tile Entity 1
0
0
10
room4.txt
19
26
0
// Tile Entity 2
0
0
9
room4.txt
19
26
0
// Tile Entity 3
0
0
8
room4.txt
19
26
0
// Tile Entity 4
0
0
7
room4.txt
19
26
0
// Tile Entity 5
2
20
8
3
0
-1
-1
// Tile Entity 6
2
11
9
3
0
-1
-1
// End of file
