room3.txt
0
20
15
basetiletypes.txt
9
10
71
-1 
// Tilemap data
0 0 0 0 0 0 0 0 0 0 0 0 0 0 0 0 0 0 0 0 
0 136 0 0 0 0 0 0 0 0 0 0 0 0 0 0 0 0 136 0 
0 138 0 0 0 0 0 0 0 0 0 0 0 0 0 0 0 0 138 0 
0 89 0 0 0 0 0 0 0 0 0 0 0 0 0 0 0 0 89 0 
0 89 0 0 0 0 0 0 0 0 0 0 0 0 0 0 0 0 89 0 
0 89 0 0 0 0 0 0 0 0 0 0 0 0 0 0 0 0 89 0 
0 89 0 0 0 0 0 0 0 0 0 0 0 0 0 0 0 0 89 0 
0 89 0 0 0 0 0 0 0 0 0 0 0 0 0 0 0 0 89 0 
1 22 0 0 0 0 0 0 0 0 0 0 0 0 0 0 0 0 21 3 
72 24 0 0 0 0 0 0 0 0 0 0 0 0 0 0 0 0 23 72 
72 24 0 0 0 0 0 0 0 0 0 0 0 0 0 0 0 0 23 72 
72 24 0 0 0 0 0 0 0 0 0 0 0 0 0 0 0 0 23 72 
72 24 91 92 92 92 92 92 92 92 92 92 92 92 92 92 92 93 23 72 
72 24 120 120 120 120 120 120 120 120 120 120 120 120 120 120 120 120 23 72 
72 24 115 115 115 115 115 115 115 115 115 115 115 115 115 115 115 115 23 72 
// Tile Entity 0
0
0
7
room1.txt
19
7
0
// Tile Entity 1
0
0
6
room1.txt
19
7
0
// Tile Entity 2
0
0
5
room1.txt
19
7
0
// Tile Entity 3
0
0
4
room1.txt
19
7
0
// Tile Entity 4
0
0
3
room1.txt
19
7
0
// End of file
